111111111111111111111111111111 /* Fila 0 */
100000000000000000000000000001 /* Fila 1 */
100000000000000000000000000001 /* Fila 2 */
100000000000001111100000000001 /* Fila 3 */
100000000000000001100000000001 /* Fila 4 */
100000000000000001100000000001 /* Fila 5 */
100001111000000001100000000001 /* Fila 6 */
100000000000000000000000000001 /* Fila 7 */
100000000000000000000011111001 /* Fila 8 */
100000000000000000000011110001 /* Fila 9 */
100000000001111000000000000001 /* Fila 10 */
100000000001111000000000000001 /* Fila 11 */
100000000001111001111000000001 /* Fila 12 */
100000000001111001100000000001 /* Fila 13 */
100000000001111000000000000001 /* Fila 14 */
100000000001111000000000000001 /* Fila 15 */
100000000000011000000110000001 /* Fila 16 */
100000000000011000000100000001 /* Fila 17 */
100000000000000000000100000001 /* Fila 18 */
100000000000000000000100000001 /* Fila 19 */
100000000000000000000000000001 /* Fila 20 */
100000000000000000000000000001 /* Fila 21 */
100000110000000000000000000001 /* Fila 22 */
100000110000000000000000000001 /* Fila 23 */
100000001100000000011000000001 /* Fila 24 */
100000001100000000011000000001 /* Fila 25 */
100000000000000000000000000001 /* Fila 26 */
100000000000000000000000000001 /* Fila 27 */
100000000000000000000000000001 /* Fila 28 */
111111111111111111111111111111 /* Fila 29 */